;Numéro;Bureau;Canton;Circo;Scrutin;Inscrits;Votants;Blancs;Nuls;Exprimés;Participation;M. LARSONNEUR Jean-Charles - votes;M. LARSONNEUR Jean-Charles - pourcentage;M. CADALEN Pierre-Yves - votes;M. CADALEN Pierre-Yves - pourcentage
0;104;CENTRE TECHNIQUE MUNICIPAL;4;02;Élections Législatives 2nd tour;805;382;22;0;360;47,45 %;186;51,67 %;174;48,33 %
1;103;CENTRE TECHNIQUE MUNICIPAL;4;02;Élections Législatives 2nd tour;759;330;22;0;308;43,48 %;185;60,06 %;123;39,94 %
2;102;PEPINIERE D'ENTREPRISES DE MEZHEVEN;4;02;Élections Législatives 2nd tour;938;435;19;0;416;46,38 %;188;45,19 %;228;54,81 %
3;079;MAIRIE DE LAMBEZELLEC;1;02;Élections Législatives 2nd tour;1177;564;35;0;529;47,92 %;294;55,58 %;235;44,42 %
4;046;GROUPE SCOLAIRE FORESTOU;5;02;Élections Législatives 2nd tour;832;490;32;0;458;58,89 %;250;54,59 %;208;45,41 %
5;041;PATRONAGE LAÏQUE SANQUER;5;02;Élections Législatives 2nd tour;869;498;20;0;478;57,31 %;193;40,38 %;285;59,62 %
6;048;MAISON POUR TOUS DU GUELMEUR;5;02;Élections Législatives 2nd tour;811;475;24;0;451;58,57 %;238;52,77 %;213;47,23 %
7;077;GROUPE SCOLAIRE BUISSON;1;02;Élections Législatives 2nd tour;838;307;27;0;280;36,63 %;133;47,50 %;147;52,50 %
8;083;GROUPE SCOLAIRE QUIZAC;1;02;Élections Législatives 2nd tour;778;251;31;0;220;32,26 %;101;45,91 %;119;54,09 %
9;084;GROUPE SCOLAIRE QUIZAC;1;02;Élections Législatives 2nd tour;734;306;21;0;285;41,69 %;153;53,68 %;132;46,32 %
10;070;GROUPE SCOLAIRE AUBRAC;1;02;Élections Législatives 2nd tour;801;383;18;0;365;47,82 %;160;43,84 %;205;56,16 %
11;071;GROUPE SCOLAIRE AUBRAC;1;02;Élections Législatives 2nd tour;0;0;0;0;0;0,00 %;0;0,00 %;0;0,00 %
12;085;GROUPE SCOLAIRE QUIZAC;1;02;Élections Législatives 2nd tour;788;250;21;0;229;31,73 %;99;43,23 %;130;56,77 %
13;049;MAIRIE DE SAINT-MARC;5;02;Élections Législatives 2nd tour;836;487;24;0;463;58,25 %;236;50,97 %;227;49,03 %
14;082;MAIRIE DE BELLEVUE (SALLE LA BARAQUE);1;02;Élections Législatives 2nd tour;664;259;17;0;242;39,01 %;133;54,96 %;109;45,04 %
15;076;GROUPE SCOLAIRE KERINOU;1;02;Élections Législatives 2nd tour;799;393;20;0;373;49,19 %;152;40,75 %;221;59,25 %
16;040;GROUPE SCOLAIRE GUERIN;2;02;Élections Législatives 2nd tour;886;507;23;0;484;57,22 %;131;27,07 %;353;72,93 %
17;078;GROUPE SCOLAIRE BUISSON;1;02;Élections Législatives 2nd tour;879;348;20;0;328;39,59 %;177;53,96 %;151;46,04 %
18;047;MAISON POUR TOUS DU GUELMEUR;5;02;Élections Législatives 2nd tour;756;331;28;0;303;43,78 %;128;42,24 %;175;57,76 %
19;065;GROUPE SCOLAIRE JACQUARD;5;02;Élections Législatives 2nd tour;907;449;21;0;428;49,50 %;138;32,24 %;290;67,76 %
20;091;PATRONAGE LAIQUE DE LA CAVALE BLANCHE;4;02;Élections Législatives 2nd tour;736;373;23;0;350;50,68 %;185;52,86 %;165;47,14 %
21;096;L.E.P. LANROZE;4;02;Élections Législatives 2nd tour;663;322;14;0;308;48,57 %;187;60,71 %;121;39,29 %
22;062;MAIRIE DE L'EUROPE;5;02;Élections Législatives 2nd tour;1000;350;21;0;329;35,00 %;149;45,29 %;180;54,71 %
23;054;FOYER LAÏQUE de SAINT-MARC;5;02;Élections Législatives 2nd tour;804;480;21;0;459;59,70 %;271;59,04 %;188;40,96 %
24;053;FOYER LAÏQUE de SAINT-MARC;5;02;Élections Législatives 2nd tour;759;378;20;0;358;49,80 %;182;50,84 %;176;49,16 %
25;098;GROUPE SCOLAIRE ROSTAND;4;02;Élections Législatives 2nd tour;873;452;28;0;424;51,78 %;214;50,47 %;210;49,53 %
26;038;PATRONAGE LAÏQUE GUERIN;2;02;Élections Législatives 2nd tour;807;486;23;0;463;60,22 %;195;42,12 %;268;57,88 %
27;036;GROUPE SCOLAIRE SANQUER;2;02;Élections Législatives 2nd tour;888;460;20;0;440;51,80 %;171;38,86 %;269;61,14 %
28;031;GROUPE SCOLAIRE JEAN MACE;2;02;Élections Législatives 2nd tour;933;496;28;0;468;53,16 %;234;50,00 %;234;50,00 %
29;052;GROUPE SCOLAIRE KERISBIAN;5;02;Élections Législatives 2nd tour;824;453;28;0;425;54,98 %;253;59,53 %;172;40,47 %
30;099;GROUPE SCOLAIRE ROSTAND;4;02;Élections Législatives 2nd tour;773;393;19;0;374;50,84 %;217;58,02 %;157;41,98 %
31;055;PATRONAGE LAIQUE du PILIER ROUGE;5;02;Élections Législatives 2nd tour;874;434;25;0;409;49,66 %;170;41,56 %;239;58,44 %
32;063;GROUPE SCOLAIRE JACQUARD;5;02;Élections Législatives 2nd tour;864;365;14;0;351;42,25 %;144;41,03 %;207;58,97 %
33;097;GROUPE SCOLAIRE ROSTAND;4;02;Élections Législatives 2nd tour;945;490;29;0;461;51,85 %;261;56,62 %;200;43,38 %
34;090;PATRONAGE LAIQUE DE LA CAVALE BLANCHE;4;02;Élections Législatives 2nd tour;760;434;21;0;413;57,11 %;228;55,21 %;185;44,79 %
35;064;GROUPE SCOLAIRE JACQUARD;5;02;Élections Législatives 2nd tour;806;398;11;0;387;49,38 %;174;44,96 %;213;55,04 %
36;030;GROUPE SCOLAIRE SIMONE VEIL;2;02;Élections Législatives 2nd tour;891;465;22;0;443;52,19 %;221;49,89 %;222;50,11 %
37;037;HOTEL DE LA METROPOLE;2;02;Élections Législatives 2nd tour;821;449;26;0;423;54,69 %;207;48,94 %;216;51,06 %
38;039;GROUPE SCOLAIRE GUERIN;2;02;Élections Législatives 2nd tour;927;516;22;0;494;55,66 %;199;40,28 %;295;59,72 %
39;100;C.E.S. PENN AR C'HLEUZ;4;02;Élections Législatives 2nd tour;783;333;32;0;301;42,53 %;175;58,14 %;126;41,86 %
40;101;C.E.S. PENN AR C'HLEUZ;4;02;Élections Législatives 2nd tour;875;383;25;0;358;43,77 %;171;47,77 %;187;52,23 %
41;089;GROUPE SCOLAIRE DUPOUY;1;02;Élections Législatives 2nd tour;815;305;16;0;289;37,42 %;98;33,91 %;191;66,09 %
42;042;PATRONAGE LAÏQUE SANQUER;5;02;Élections Législatives 2nd tour;825;401;12;0;389;48,61 %;135;34,70 %;254;65,30 %
43;045;GROUPE SCOLAIRE FORESTOU;5;02;Élections Législatives 2nd tour;781;408;23;0;385;52,24 %;209;54,29 %;176;45,71 %
44;087;GROUPE SCOLAIRE KERHALLET;1;02;Élections Législatives 2nd tour;692;309;18;0;291;44,65 %;155;53,26 %;136;46,74 %
45;073;GROUPE SCOLAIRE DUKAS;1;02;Élections Législatives 2nd tour;761;258;23;0;235;33,90 %;88;37,45 %;147;62,55 %
46;074;GROUPE SCOLAIRE DUKAS;1;02;Élections Législatives 2nd tour;856;420;21;0;399;49,07 %;195;48,87 %;204;51,13 %
47;080;MAIRIE DE BELLEVUE (SALLE LA BARAQUE);1;02;Élections Législatives 2nd tour;632;272;18;0;254;43,04 %;113;44,49 %;141;55,51 %
48;027;MAIRIE CENTRALE;2;02;Élections Législatives 2nd tour;904;496;19;0;477;54,87 %;287;60,17 %;190;39,83 %
49;029;GROUPE SCOLAIRE SIMONE VEIL;2;02;Élections Législatives 2nd tour;864;430;20;0;410;49,77 %;176;42,93 %;234;57,07 %
50;081;MAIRIE DE BELLEVUE (SALLE LA BARAQUE);1;02;Élections Législatives 2nd tour;525;186;6;0;180;35,43 %;66;36,67 %;114;63,33 %
51;075;GROUPE SCOLAIRE KERINOU;1;02;Élections Législatives 2nd tour;954;418;25;0;393;43,82 %;166;42,24 %;227;57,76 %
52;072;GROUPE SCOLAIRE DUKAS;1;02;Élections Législatives 2nd tour;747;333;26;0;307;44,58 %;135;43,97 %;172;56,03 %
53;086;GROUPE SCOLAIRE KERHALLET;1;02;Élections Législatives 2nd tour;709;231;12;0;219;32,58 %;96;43,84 %;123;56,16 %
54;044;GROUPE SCOLAIRE PILIER ROUGE;5;02;Élections Législatives 2nd tour;836;416;21;0;395;49,76 %;158;40,00 %;237;60,00 %
55;088;GROUPE SCOLAIRE DUPOUY;1;02;Élections Législatives 2nd tour;737;244;18;0;226;33,11 %;85;37,61 %;141;62,39 %
56;043;GROUPE SCOLAIRE PILIER ROUGE;5;02;Élections Législatives 2nd tour;936;433;15;0;418;46,26 %;154;36,84 %;264;63,16 %
57;028;MAIRIE CENTRALE;2;02;Élections Législatives 2nd tour;885;455;29;0;426;51,41 %;227;53,29 %;199;46,71 %
58;032;GROUPE SCOLAIRE JEAN MACE;2;02;Élections Législatives 2nd tour;977;581;35;0;546;59,47 %;332;60,81 %;214;39,19 %
59;035;GROUPE SCOLAIRE SANQUER;2;02;Élections Législatives 2nd tour;824;420;20;0;400;50,97 %;153;38,25 %;247;61,75 %
60;095;L.E.P. LANROZE;4;02;Élections Législatives 2nd tour;860;396;25;0;371;46,05 %;209;56,33 %;162;43,67 %
61;061;GROUPE SCOLAIRE PEN-AR-STREAT;5;02;Élections Législatives 2nd tour;920;220;12;0;208;23,91 %;59;28,37 %;149;71,63 %
62;066;GROUPE SCOLAIRE KERICHEN;5;02;Élections Législatives 2nd tour;819;373;20;0;353;45,54 %;143;40,51 %;210;59,49 %
63;092;GROUPE SCOLAIRE QUESTEL;4;02;Élections Législatives 2nd tour;933;408;18;0;390;43,73 %;194;49,74 %;196;50,26 %
64;059;MAISON POUR TOUS DE PEN AR CRÉACH;5;02;Élections Législatives 2nd tour;731;230;16;0;214;31,46 %;91;42,52 %;123;57,48 %
65;050;GROUPE SCOLAIRE J. KERHOAS;5;02;Élections Législatives 2nd tour;828;428;25;0;403;51,69 %;215;53,35 %;188;46,65 %
66;057;GROUPE SCOLAIRE KERBERNARD;5;02;Élections Législatives 2nd tour;771;361;16;0;345;46,82 %;183;53,04 %;162;46,96 %
67;068;GROUPE SCOLAIRE KERICHEN;5;02;Élections Législatives 2nd tour;871;420;21;0;399;48,22 %;193;48,37 %;206;51,63 %
68;034;GROUPE SCOLAIRE SANQUER;2;02;Élections Législatives 2nd tour;744;435;23;0;412;58,47 %;209;50,73 %;203;49,27 %
69;033;GROUPE SCOLAIRE JEAN MACE;2;02;Élections Législatives 2nd tour;874;489;31;0;458;55,95 %;284;62,01 %;174;37,99 %
70;056;PATRONAGE LAIQUE du PILIER ROUGE;5;02;Élections Législatives 2nd tour;703;282;15;0;267;40,11 %;105;39,33 %;162;60,67 %
71;069;GROUPE SCOLAIRE AUBRAC;1;02;Élections Législatives 2nd tour;840;466;19;0;447;55,48 %;168;37,58 %;279;62,42 %
72;051;GROUPE SCOLAIRE KERISBIAN;5;02;Élections Législatives 2nd tour;881;487;23;0;464;55,28 %;257;55,39 %;207;44,61 %
73;093;GROUPE SCOLAIRE QUESTEL;4;02;Élections Législatives 2nd tour;1005;485;35;0;450;48,26 %;225;50,00 %;225;50,00 %
74;067;GROUPE SCOLAIRE KERICHEN;5;02;Élections Législatives 2nd tour;791;367;13;0;354;46,40 %;155;43,79 %;199;56,21 %
75;058;GROUPE SCOLAIRE KERBERNARD;5;02;Élections Législatives 2nd tour;822;317;19;0;298;38,56 %;133;44,63 %;165;55,37 %
76;060;CENTRE SOCIAL DE PEN AR CRÉACH;5;02;Élections Législatives 2nd tour;952;431;21;0;410;45,27 %;207;50,49 %;203;49,51 %
77;094;GROUPE SCOLAIRE QUESTEL;4;02;Élections Législatives 2nd tour;698;338;18;0;320;48,42 %;166;51,88 %;154;48,13 %
